[
	[0,0,0,0,0,0,0,0,0,0,0,0,0,0,0,0,0,0,0,0],
	[0,0,0,0,0,0,0,0,0,0,0,0,0,0,0,0,0,0,0,0],
	[0,0,0,0,0,0,0,0,0,0,0,0,0,0,0,0,0,0,0,6],
	[0,0,0,0,0,0,8,0,0,0,0,8,0,0,0,0,0,0,0,6],
	[6,0,0,0,0,0,5,5,5,5,5,5,0,0,0,0,0,0,0,6],
	[6,8,0,0,8,0,5,5,5,5,5,5,0,8,0,0,0,0,0,6],
	[6,5,0,0,5,5,5,5,0,0,5,5,5,5,0,0,0,0,0,6],
	[6,0,0,0,5,5,5,5,0,0,5,5,5,5,0,8,0,0,8,6],
	[6,0,0,0,5,5,0,0,5,5,5,5,5,5,5,5,0,0,5,6],
	[6,0,0,0,5,5,0,0,5,5,5,5,5,5,5,5,0,0,0,6],
	[6,0,0,0,5,5,5,5,5,5,5,5,5,5,5,5,0,0,0,6],
	[6,0,0,0,5,5,5,5,5,5,5,5,5,5,5,5,0,0,0,6],
	[6,0,0,0,5,5,5,5,5,5,5,5,5,5,5,5,0,0,0,6],
	[6,0,0,0,5,5,5,5,5,5,5,5,5,5,0,0,0,0,0,6],
	[6,0,0,0,0,0,5,5,5,5,5,5,5,5,0,0,0,0,0,6],
	[6,0,0,0,6,0,5,5,5,5,5,5,0,0,0,6,0,0,2,6],
	[6,0,8,0,6,0,0,0,0,0,0,0,0,0,0,6,0,8,0,6],
	[6,5,5,5,6,0,0,0,0,0,0,0,0,0,0,6,5,5,5,6],
	[6,0,0,0,6,0,0,0,0,0,0,0,0,0,0,6,0,0,0,6],
	[6,0,0,0,6,0,0,0,0,0,0,0,0,0,0,6,0,0,0,6],
	[6,0,0,0,6,2,0,0,1,0,0,0,0,0,0,6,2,0,0,6],
	[6,9,8,0,6,0,0,0,0,0,0,0,0,8,0,6,0,8,0,6],
	[5,5,5,5,5,5,5,5,5,5,5,5,5,5,5,5,5,5,5,5]
]