[
	[0,0,0,0,0,0,0,0,0,0,0,0,0,0,0,0,0,0,0,0],
	[0,0,0,0,0,0,0,0,0,0,0,0,0,0,0,0,0,0,0,0],
	[0,0,0,0,6,0,2,0,0,6,0,0,0,0,0,0,0,6,0,0],
	[0,0,0,0,6,0,0,8,0,6,0,0,9,0,8,0,0,6,0,8],
	[0,0,0,0,6,5,5,5,5,6,5,0,5,5,5,5,5,6,5,5],
	[0,0,0,0,6,0,0,0,0,6,0,0,0,0,0,0,0,6,0,0],
	[0,0,0,0,6,0,0,0,0,6,0,0,0,0,0,0,0,6,0,0],
	[0,0,6,0,6,0,6,0,0,6,0,0,0,6,0,0,0,6,0,0],
	[9,0,6,0,6,0,6,8,0,6,9,0,0,6,0,0,0,6,0,0],
	[5,5,6,5,5,5,6,5,5,6,5,0,5,6,5,5,5,5,5,5],
	[0,0,6,0,0,0,6,0,0,6,0,0,0,6,0,0,0,0,0,0],
	[0,0,6,0,0,0,6,0,0,6,0,0,0,6,0,0,0,0,0,0],
	[0,0,6,0,0,0,6,0,0,6,0,0,0,6,0,0,2,6,0,0],
	[8,0,6,0,0,0,6,8,0,6,0,0,0,6,0,0,0,6,0,8],
	[5,5,6,5,0,5,6,5,5,5,5,5,5,5,5,0,5,6,5,5],
	[0,0,6,0,0,0,6,0,0,0,0,0,0,0,0,0,0,6,0,0],
	[0,0,6,0,0,0,6,0,0,0,0,0,0,0,0,0,0,6,0,0],
	[0,2,6,0,0,0,6,0,0,6,0,0,0,0,0,0,0,6,0,0],
	[8,0,6,0,8,0,6,0,0,6,0,0,0,8,0,0,9,6,0,0],
	[5,5,6,5,5,5,5,0,5,6,5,0,5,5,5,0,5,6,5,5],
	[0,0,6,0,0,0,0,0,0,6,0,0,0,0,0,0,0,6,0,0],
	[0,0,6,0,0,0,0,0,0,6,0,0,0,0,0,0,0,6,0,0],
	[0,0,6,0,0,0,0,1,0,6,0,0,0,0,0,0,0,6,0,0],
	[9,0,6,9,0,8,0,0,0,6,0,0,8,0,0,9,0,6,0,0],
	[5,5,5,5,0,5,5,5,5,5,5,5,5,5,5,5,5,5,5,5]
]